5 10 15
##########
#    $   #
#  . @   #
#  $  $  #
##########
