3 5 1 7 2 8 4 6 9 10
##############
#   #    #   #
# $   $$   $ #
#  # ## ## # #
#  $  .  .  .#
# $ ######   #
# .  # @ # . #
# $  ####  $ #
#  $ .  .  $ #
#  ## ## ##  #
#     $   $  #
#  #       # #
##############
