1 99
 ###########
##         #
#          #
# $$       #
#. @      .#
############