22 24
##########
#  .  $  #
# @   $  #
# $      #
##########
