2 5 11
##########
#     $  #
#.   @$  #
# $   .  #
##########
