6 9 3
##########
#$    .  #
# @ $    #
#.    $  #
##########
