3 7 
##########
#@ $     #
# .  $   #
#     .  #
##########
