8 14
##########
#  @ .   #
# $   $  #
#    $   #
##########
