13 17 19
##########
#   @    #
# $ $    #
# .   .  #
##########
